XXXXXXXXXXXXXXXXXXXXXXXXXXXXXXXXXXXXXXXXXXXXXXXXXX
XXXXXXXXX               XXXXX       XXXXXXXXXXXXXX
XXXXXXXXX   XXXXXXXXX   XXXXX       XXXXXXXXXXXXXX
XXXXXXXXX   XXXXXXXXX   XXXXX                     
X           XXXXXXXXX   XXXXX       XXXXXXXXXXXXXX
XXXXXXXXXXXXXXXXXXXXX   XXXXXXXXX   XXXXXXXXXXXXXX
XXX       XXXXX         XXXXXXX     XXXXXXXXXXXXXX
XXXXX                   XXXXX       XXXXXXXXXXXXXX
XXXXXXXXXXXXX                       XXXXXXXXXXXXXX
XXXXXXXXXXXXXXXXXXXXXXXXXXXXXXXXXXXXXXXXXXXXXXXXXX